111111111111111111111
1E0000000000000C000C1
101001010010000010111
101001001010101000111
1P0000000C00C00000001
1P0000000C00C00000001
1P0000000C00C00000001
111111111111111111111