111111111111
1E0000000001
1P00000000C1
100000000001
100000000001
111111111111