11111111111111111
1E1000100000001C1
10100010111000001
1P0000101000000C1
11111111111111111