111111111111111111111
1E0000000000000C000C1
101001010P00000010111
101001001010101000111
100000000000000000001
100000000000000000001
111111111111111111111
111111111111111111111