11111111111111111
1P0000000000000C1
1111E111101111111
1C000000000000011
11111111111111011
1C000000000000001
11111111111111111