11111111111111111
1E1000100000001C1
10100010111000001
1P0000101000000C1
10000010100000001
10000010100000001
10000010100000001
10000000000000001
11111111111111111