11111111111111111
1E1000000000001C1
10100010111000001
1P0000001000000C1
11111111111111111