111111111111111111111
1E10000000000000001C1
101000000P00000000001
1000000000000000000C1
111111111111111111111