111111111111111111111
1E10000000000000001C1
101000000P00000000001
101010101010101010101
100100000000000000001
1001C0000000000000001
100111111111101111111
1000000000000000000C1
111111111111111111111