1111111111111111
1P000000000000E1
1000C11110111111
1111100000000001
1C00000000000001
1111111111111101
1C00000000000001
1111111111111111