11111111111111111
1P000000000000E01
1000C111101111111
111110000000001C1
1C000000000000001
11111111111111001
1C0000000000000C1
11111111111111111