111111111111
1E0000G00001
1P00G00000C1
1000000G0001
100000000001
111111111111