111111111111
1E00000000C1
1P00G0000001
1000000G00C1
100C00000001
111111111111