1111111111111111
1P000000000000E1
1000C11110111111
111110000000G001
1CG0000G000000G1
10G111111111G001
1C000000000000C1
1111111111111111