11111111111111111111111
1P00C0000000000000000C1
1000E111101111110000001
11111000000000C10000101
1C00000000000001000010
11111111111111010000101
1C0000000000000100001C1
11111111111111111111111